10
0 1 1 3 1 2 2 4 5 1
2 2 4 5 1 2 1 1 3 1
3 4 6 6 2 4 5 5 5 6
4 5 5 5 6 3 4 6 6 2
6 6 3 1 1 2 2 4 5 1
4 5 5 5 6 6 1 1 3 1
3 1 1 3 1 2 2 4 5 1
2 2 4 5 1 2 1 1 3 1
1 2 3 4 5 6 6 2 1 1
6 5 2 4 3 5 2 3 7 1
