5
0 4 4 3 4
2 2 4 5 4
3 4 6 6 2
4 5 5 5 6
6 6 7 4 4
