10
0 2 2 3 4 2 2 4 5 4
2 2 4 5 4 2 4 4 3 4
3 4 6 6 2 4 5 5 5 6
4 5 5 5 6 3 4 6 6 2
6 6 3 4 4 2 2 4 5 4
4 5 5 5 6 6 4 4 3 4
3 4 4 3 4 2 2 4 5 4
2 2 4 5 4 2 4 4 3 4
4 2 3 4 5 6 6 2 4 4
6 5 2 4 3 5 2 3 7 4
